BARK	B AA R K
BYE	B AY
DOGS	D AA G Z
DOGS(2)	D AO G Z
ERIC	EH R IH K
GOOD	G UH D
GOOD(2)	G IH D
GREETINGS	G R IY T IH NG Z
HELLO	HH AH L OW
HELLO(2)	HH EH L OW
HI	HH AY
NO	N OW
PEARL	P ER L
RENEE	R AH N EY
ROBOT	R OW B AA T
ROBOT(2)	R OW B AH T
SHADY	SH EY D IY
THANK	TH AE NG K
TIMMY	T IH M IY
YES	Y EH S
YOU	Y UW
